(
        'DDDDDDDDDDDDDDDDDDDDDDDDDDDDDDDDDDDDDDDDDDDDDDDDDDDDDDDDDDDDDDDDDDDDDDDDDDDDDDDDDDDDDDDDDDDDDDDDDDDDDDDDDDDDDDDDDDDDDDDDDDDDDDDDDDDDDDDDDDDDDDDDDDDDDDDDDDDDDDDDDDDDDDDDDDDDDDDDDDDDDDD',
	'DH                               N            D                                  N                    D                                                D                              D',
	'D                                            DED                                                     DED                                              DED                             D',
	'D                                             D                                                       D                                                D                              D',
	'D                                                                                                                                                                                     D',
	'D                                                                                                                                                                                     D',
        'D      PPP                                                                                                                                                                            D',
        'D                                                                                                                                                                                     D',
        'D       *                                                                                             D                                                                               D',
        'D      PPP     P     P     P     P     P     P     P     P     P     P     P     P     P H   P     P DED P     P     P     P     P     P     P     P     P     P     P     P     P    D',
        'D                                   D                                                                 D                                                                   D           D',
        'D                D                 D D                                                                                                                                   DED          D',
        'D               DED               D   D                                                                                   D                                               D           D', 
        'D                D               D     D      H           D                                                              DED                                                          D',
        'D                               D       D                DED                                                              D                                                           D',
        'D                              D         D                D                                                                                                                           D',
        'D                             D           D                                                                                                                                           D',
        'D                            D             D                                                                                                               D                          D',
        'D                           D               D                                                                                                             DED                         D',
        'D                          D                 D                                            D                                                                D                          D',
        'D        D                D                   D                                          DED                                                                                          D',
        'D       DED              D                     D                                          D                                       E                                                   D',
        'DDDDDDDDDDDDDDDDDDDDDDDDDDDDDDDDDDDDDDDDDDDDDDDDDDDDDDDDDDDDDDDDDDDDDDDDDDDDDDDDDDDDDDDDDDDDDDDDDDDDDDDDDDDDDDDDDDDDDDDDDDDDDDDDDDDDDDDDDDDDDDDDDDDDDDDDDDDDDDDDDDDDDDDDDDDDDDDDDDDDDDD'
        )
