(
    'PPPPPPPPPPPPPPPPPPPPPPPPPPPPPPPPPPPPPPPPPPPPPPPPP',
    'P                       PBCBCBCBCBCBCBCBCBCBCBCBP',
    'P                       PCCCCCCCCCCCCCCCCCCCCCCCP',
    'P                       P                       P',
    'P                       P                       P',
    'P                       P                       P',
    'P                       P                       P',
    'P                       P                       P',
    'P                       P                       P',
    'P                       P                       P',
    'P       PPP             P                       P',
    'P                       P                       P',
    'P                       P                       P',
    'PP                      P                       P',
    'P                 P     P                       P',
    'P                       P                       P',
    'P     P                 PP                      P',
    'P     P                 P                       P',
    'P*    P                   P                     E',
    'PPPPPPPPPPPTTTPPPPPPPPPPPPPPPPPPPPPPPPPPPPPPPPPPP',
    'PPPPPPPPPPPPPPPPPPPPPPPPPPPPPPPPPPPPPPPPPPPPPPPPP', 
)
