(
        "PPPPPPPPPPPPPPPPPPPPPPPPPPPPPPPPPPPPPPPPPPPPPPPPPPPPPPPEEEPPPPPPPPPP",
        "P                    P          TTTTTTTTTTTTT        P             P",
        "P                       P   p                       P              P",
        "P      S                                           P               P",
        "P               P  P  P  P  P  PTTTTTTTTTTTTT      P               P",
        "P                                                                  P",
        "PS                                                                 P",
        "P                                              PPPP                P",
        "P    P      P                                                      P",
        "P                                                      T           P",
        "P                          P  P                                    P",
        "P                 P   PP                                           P",
        "P                                                                  P",
        "P                                                                  P",
        "P                     PPPPPP                                       P",
        "P                                                                  P",
        "P                                                                  P",
        "P   P  PPP   PP                                                    P",
        "P                                                                  P",
        "P                                       PPPP                       P",
        "P                                      PPPPPP                      P",
        "P                                     PPPPPPPP                     P",
        "P                                    PPPPPPPPPP                    P",
        "P                                   PPPPPPPPPPPP    T              P",
        "PPPPPPPPPPPPPPPPPPPPPPPPPPPPPPPPPPPPPPPPPPPPPPPPPPPPPPPPPPPPPPPPPPPP",
        )