(
'DDDDDDDDDDDDDDDDDDDDDDDDDDDDDDDDDDDDDDDDDDDDDDDDDDDDDDDDDDDDDDDDDDDDDDDDDDDDD',
'D                                                                           D',
'D                                                                           D',
'D                                                                           D',
'D                                                                           D',
'D                               HH         HH                               D',
'D                              HMMH       HMMH                              D',
'D                              M  MH     HM  M                              D',
'D                              M   MH   HM   M                              D',
'D                              M    MH HM    M                              D',
'D                              M     MHM     M                              D',
'D                              M      M      M                              D',
'D                              M             M                              D',
'D                              M             M                              D',
'D          PPPPPPPPPPPPPPPPPPTSPPPPPPPPPPPPPPPPPPPSTPPPPPPPPPPPPPPP         D',
'D          PPPPPPPPPPPPPPPPPPM PPPPPPPPPPPPPPPPPPP MPPPPPPPPPPPPPPP         D',
'DN         PPPPPPPPPPPPPPPPPPPPPPPPPPPPPPPPPPPPPPPPPPPPPPPPPPPPPPPP        ND',
'DP         PPPPPPPPPPPPPPPPPPPPPPPPPPPPPPPPPPPPPPPPPPPPPPPPPPPPPPPP        PD',
'D          PPPPPPPPPPPPPPPPPPPPPPPPPPPPPPPPPPPPPPPPPPPPPPPPPPPPPPPP         D',
'D          PPPPPPPPPTSPPPPPPPPPPPPPPPPPPPPPPPPPPPPPPPPPPPPPPPPPPPPP         D',
'D          PPPPPPPPPM PPPPPPPPPPPPPPPPPPPPSTPPPPPPPPPPPPPPPPPPPPPPP         D',
'D          PPPPPPPPPPPPPPPPPPPPPPPPPPPPPPP MPPPPPPPPPPPPPPPPPPPPPPP         D',
'D          PPPPPPPPPPPPPPPPPPPPPPPPPPPPPPPPPPPPPPPPPPPPPPPPPPPPPPPP         D',
'D          PPPPPPPPPPPPPPPPPPPPTSPPPPPPPPPPPPPPPPPPPPPPPPPPPPPPPPPP         D',
'D          PPPPPPPPPPPPPPPPPPPPM PPPPPPPPPPPPPPPPPPPPPPPPPPPSTPPPPP         D',                                                                             
'D          PPPPPPPPPPPPPPPPPPPPPPPPPPPPPPPPPPPPPPPPPPPPPPPPP MPPPPP         D',
'D          PPPPPPPPPTSPPPPPPPPPPPPPPPPPPPPPPPPPPPPPPPPPPPPPPPPPPPPP         D',
'D          PPPPPPPPPM PPPPPPPPPPPPPTTTTTTTTPPPPPPPPPPPPPPPPPPPPPPPP         D',
'D          PPPPPPPPPPPPPPPPPPPPPPPPTMMMMMMTPPPPPPPPPPPPPPPPPPPPPPPP         D',
'D          PPPPPPPPPPPPPPPPPPPPPPPPTMSSSSMTPPPPPPPSTPPPPPPPPPPPPPPP         D',
'D          PPPPPPPPPPPPPPPPPPPPPPPPTM    MTPPPPPPP MPPPPPPPPPPPPPPP         D',
'D          PPPPPPPPPPPPPPPPPPPPPPPPTMSSSSMTPPPPPPPPPPPPPPPPPPPPPPPP         D',
'D          PPPPPTSPPPPPPPPPPPPPPPPPTM    MTPPPPPPPPPPPPPPPPPPPPPPPP         D',
'D          PPPPPM PPPPPPPPPPPPPPPPPTMMMMMMTPPPPPPPPPPPPPPPPPPPPPPPP         D',
'D          PPPPPPPPPPPPPPPPPPPPPPPPTTTTTTTTPPPPPPPPPPPPPPPPPPPPPPPP         D',
'D          PPPPPPPPPPPPPPPPPPPPPPPPPPPPPPPPPPPPPPPPPPPPPPPPPPPPPPPP         D',
'DPPPPPPPPPPPPPPPPPPPPPPPPPPPPPPPPPPPPPPPPPPPPPPPPPPPPPPPPPPPPPPPPPPPPPPPPPPPD',
'DDDDDDDDDDDDDDDDDDDDDDDDDDDDDDDDDDDDDDDDDDDDDDDDDDDDDDDDDDDDDDDDDDDDDDDDDDDDD',
'DDDDDDDDDDDDDDDDDDDDDDDDDDDDDDDDDDDDDDDDDDDDDDDDDDDDDDDDDDDDDDDDDDDDDDDDDDDDD',
'DDDDDDDDDDDDDDDDDDDDDDDDDDDDDDDDDDDDDDDDDDDDDDDDDDDDDDDDDDDDDDDDDDDDDDDDDDDDD'
)
