(
	'DPPPPPPPPPPPPPPPPPPPPPPPPPPPPPPPPPPPPPPPPPPPPPPPPPPPPPPPPPPPPPPPPPPPPPPPPPPPPPPPPPPPPPPPPPPPD',
        'DP*          H                       S S S  PPPPP  S S S                                   PD',
        'DPPPT  TPPPPPPPPPPPPPPPPPPPPPPPPPPPPP P P P       P P P PPPPPPPPPPPPT  TPPPPPPPPPPPPPPPPPPPPD',
        'DP                 CNCNCNC           PPPPPPPPPPPPPPPPPPP B                                 PD',
        'DP                  C C C                                                                  PD',
        'DP                                                                                         PD',
        'DP                                                                                         PD',
        'DP                                                                                         PD',
        'DP B                                                                                       PD',
        'DP                                                                              C          PD',
        'DP                                   C                                         CNC         PD',
        'DP                                  CNC                                         C          PD',
        'DP                                   C                                                     PD',
        'DP                                                                                         PD',
        'DP                                                                                         PD',
        'DP                   C                                                                     PD',
        'DP                  CNC                                                                    PD',
        'DPC                  C                                                                     PD',
        'DPNC                                                                                       PD',
        'DPC                                                                                        PD',
        'DP                                                                                         PD',
        'DP                                                                                         PD',
        'DP                                                                                         PD',
        'DP                                                                                         PD',
        'DP                                                                                         PD',
        'DP                                                                                         PD',
        'DP                                                                                         PD',
        'DP                                                                  CE                     PD',
        'DP                                                                                         PD',
        'DP                                                                                         PD',
        'DP                                                                                         PD',
        'DP                                                                                         PD',
        'DP                                                                                         PD',
        'DPP    CC PP CCC  CCCC PP     CP PPPP CCP PPPPPCCPP  PP  C  PP                             PD',
        'DP                                                                                         PD',
        'DP                                                                                         PD',
        'DP                                                                                         PD',
        'DP                                                                                         PD',
        'DP                                                                                         PD',
        'DP                                                                                         PD',
        'DP                                                                                         PD',
        'DP      C      C                     C                                       CT            PD',
        'DP     CNC    CNC                   CNC                                     CNC            PD',
        'DP      C      C                     C                                       C             PD',
        'DP                                                                                         PD',
        'DP                                                                                         PD',
        'DP                                                                                         PD',
        'DP                                                                                         PD',
	'DDDDDDDDDDDDDDDDDDDDDDDDDDDDDDDDDDDDDDDDDDDDDDDDDDDDDDDDDDDDDDDDDDDDDDDDDDDDDDDDDDDDDDDDDDDDD',
        'DDDDDDDDDDDDDDDDDDDDDDDDDDDDDDDDDDDDDDDDDDDDDDDDDDDDDDDDDDDDDDDDDDDDDDDDDDDDDDDDDDDDDDDDDDDDD',
        'DDDDDDDDDDDDDDDDDDDDDDDDDDDDDDDDDDDDDDDDDDDDDDDDDDDDDDDDDDDDDDDDDDDDDDDDDDDDDDDDDDDDDDDDDDDDD'
)
