(
'DDDDDDDDDDDDDDDDDDDDDDDDDDDDDDDDDDDDDDDDDDDDDDDDDDDDDDDDDDDDDDDDDDDDDDDDDDDDD',
'DMMMNMMMMMMNMMMMMMNMMMMMMNMMMMMMNMMMMMMNMMMMMMNMMMMMMNMMMMMMNMMMMMMNMMMMMMNMD',
'DCCCCCCCCCCCCCCCCCCCCCCCCCCCCCCCCCCCCCCCCCCCCCCCCCCCCCCCCCCCCCCCCCCCCCCCCCCCD',
'D*                                                                          D',
'D                                                                           D',
'D                               HH         HH                               D',
'D                              HMMH       HMMH                              D',
'D                              M  MH     HM  M                              D',
'D                              M   MH   HM   M                              D',
'D                              M    MH HM    M                              D',
'D                              M     MHM     M                              D',
'D                              M      M      M                              D',
'D                              M             M                              D',
'D                              M             M                              D',
'D          PPPPPPPPWPPPPPPPPPTSPPPPPPPPPPPPPPPPPPWSTPPPWPPWPPPPPPPP         D',
'D          PPPPPPPPPPPWPPPPPPM PPPPPWPPPPPPPPPPPPP MPPPPPPPPPPPPPPP         D',
'DN         PWPWPPPPPPPPPPPPPPPPPPPPPPPPWWPPPPPPPPPPPPPPPPPPPPPPPPPP        ND',
'DW         PPPPPPPWPPPPPWPPPPPPPPPPPPPPPPPPPPPPPPPPPPPPPPPPWPPPPPPP        WD',
'D          PPPPPPPPPPPPPPPPPPPPPPPPPPPPPPPPPPPPPPWPPPPPPPPPPPPPPPPP         D',
'D          PPPPPPPPPTSPPPPPPPPPPPPPPPPPPPPPPPPPPPPPPPPPPPPPPPPPPPPP         D',
'D          PPPPPPPPPM PPPPPPPPPPPPPWWPPPPSTPPPPPPPPPPPPWPPPPPPPPPPP         D',
'D          PPPPPPPPPPPPPPPPWPPPPPPPPWPPPP MPPPPPPPPPPPPPPPPPPPPWPPP         D',
'D          PPWWPPPPPPPPPPPPPPPPPPPPPPPPPPPPPPPPPPPWPPPPPPPPPPPPPPPP         D',
'D          PPPPPPPPPPPPPWPPPPPPTSPPPPPPPPPWPPPPPPPPPPPPPPPPPPPPPPPP         D',
'D         WPPPPPPPPPPPPPPPPPPPPM PPPPPPPPPPPPPPPPPPPPPPPPPPPSTPPPPPW        D',                                                                             
'D        WMPPPPPWPPPPPPPPPPPPPPPPPPPPPPPPWPPPPPPPPPPPPPPPPPP MPPPPPMW       D',
'D        WMPPPPPPPPPTSPPPPPPPWPPPPPPPPPPPPPPPPPPPPPPWPPPPPPPPPPPPPPMW       D',
'D         WPPPPPPPPPM PPPPPPPPPPPPWTTTTTTTTWPPPPPPPPPPPPPPPPPPPPPPPW        D',
'D          PPPPPPPPPPPPPPPWPPPPPPPWTMMMMMMTWPPPPPPPPPPPPPPPPPPPPPPP         D',
'D          PPPPPPPPPPPPPPPPPPPPPPPWTMSSSSMTWPPPPPPSTPPPPPPPPPPPPPPP         D',
'D          PPPPPPPPPWPPPPPPPPPPPPPWTM    MTWPPPPPP MPPPPPPPPWPPPPPP         D',
'D          PPPPPPPPPPPPPPWWPPPPPPPWTMSSSSMTWPPPPPPPPPPPPPPPPPPPPPPP         D',
'D          PPPPPTSPPPPPPPPPPPPPPPPWTM    MTWPPPPWPPPPPPPPPPPPPPPPPP         D',
'D          PPPPPM PPPPPPPPPPPPPPPPWTMMMMMMTWPPPPPPPPPPPPPWPPPPPPPPP         D',
'D          PPPPPPPPPPPPWWPPPPPPPPPWTTTTTTTTWPPPPWPPPPPPPPPPPPPPPPPP         D',
'D          PPPPPPPPPPPPPPPPPPPPPPPWWWWWWWWWWPPPPPPPPPPPPPPPPPPPPPPP         D',
'DWPPPPPPPPPPPPPWWPPPPPPPPPPPPPPPPPPPPPPPPPPPPPPPPPPWWPPPPPPPPPPPPPPPPPPPPPPWD',
'DDDDDDDDDDDDDDDDDDDDDDDDDDDDDDDDDDDDDDDDDDDDDDDDDDDDDDDDDDDDDDDDDDDDDDDDDDDDD',
'DDDDDDDDDDDDDDDDDDDDDDDDDDDDDDDDDDDDDDDDDDDDDDDDDDDDDDDDDDDDDDDDDDDDDDDDDDDDD',
'DDDDDDDDDDDDDDDDDDDDDDDDDDDDDDDDDDDDDDDDDDDDDDDDDDDDDDDDDDDDDDDDDDDDDDDDDDDDD'
)
