              (
        "PPPPPPPPPPPPPPPPPPPPPPPPPPPPPE   T",
        "P*P          SPS PPP      P PPT  P",
        "P PP PPPPPPPP P   P  PPPP     P  T",
        "P PP    P   P   P   P     P P T  P",
        "P PP    P P P P PPP   PPP   P P  T",
        "P PP    P P P   P   P   PPPPP T  P",
        "PSTP    P P P P   P   P T P   P  T",
        "P  PTP    P P   P   P       PPP  P",
        "PP PPPPPPPP PTP   P   PP TP P    P",
        "TT TTTTTTTTSTTTTTTTTTTTT  PPP  PTP",
        "T       T     T         T P      P",
        "T T    T     T          T P      P",
        "T       T     T      T  T P      P",
        "T        T   T      T   T P      P",
        "T                  T    T P P  PPP",
        "T   T               T   T P  TT  P",
        "T       T            T  T P      P",
        "T                   T   T PT     P",
        "T T   T   T T      T    T P      P",
        "T                   T   T P      P",
        "T                    T  T P      P",
        "T    T          T       T P      P",
        "T                       T P      P",
        "T                    T  T P      P",
        "T T                     T P      P",
        "T            T          T P      P",
        "T                       T P P    P",
        "T     T             T   T   P    P",
        "TTTTTTTTTTTTTTTTTTTTTTTTTPPPPTTTTP"
        )
