(
    'PPPPPPPPPPPPPPPPPPPPPPPPPPPPPPPPPPPPPPPPPPPPPPPPP',
    'P            N          P B                     P',
    'P           N           P                       P',
    'P          N            P H                     P',
    'P                       P                       P',
    'P                       P                       P',
    'P                       P                       P',
    'P                       P                       P',
    'P                       P                       P',
    'P                       P                       P',
    'P       PPP             P                       P',
    'P                       P                    G  P',
    'P                       P                       P',
    'PP                      P                       P',
    'P                 P     P                       P',
    'P                       P                       P',
    'P     P                 PP                      P',
    'P     P                 P                       P',
    'P     P                   P                     E',
    'PPPPPPPPPPPTTTPPPPPPPPPPPPPPPPPPPPPPPPPPPPPPPPPPP',
    'PPPPPPPPPPPPPPPPPPPPPPPPPPPPPPPPPPPPPPPPPPPPPPPPP', 
)
