(
        "WWWWWVWWWWWWWVWWWWWWWVWWWWWWWVWWWWWWWVWWWWWWWVWWWWWVWWWEWWWWWVWWWWWWWVWWWWWWWVWWWWWWWVWWWWWWWVWWWWWWWVWWW",
        "W                                                                                                       W",
        "WI I I I I I I I I I I I I I I I I I I I I I I I I I I I I I I I I I I I I I I I I I I I I I I I I I I IW",
        "W                                                                                                       W",
        "W                                                                                                       W",
        "W WWWWWVWWWWWWWVWWWWWWWVWWWWWWWVWWWWWWWVWWWWWWWVWWWWWWWVWWWWWWWVWWWWWWWVWWWWWWWVWWWWWWWVWWWWWWWVWWWWWVWWW",
        "W       I                  I             I                        I           I I                      IW",
        "WI                                                   I                               I        I         W",
        "W             I I               I                          I                                        I   W",
        "W     I               I                     I                         I                    I            W",
        "WWWWWVWWWWWWWVWWWWWWWVWWWWWWWVWWWWWWWVWWWWWWWVWWWWWWWVWWWWWWWVWWWWWWWVWWWWWWWVWWWWWWWVWWWWWWWVWWWWWVWWW W",
        "W                                                                           I                          IW",
        "W                                                                                                       W",
        "W                                                                                                       W",
        "W                                                                                                       W",
        "W WWWWWVWWWWWWWVWWWWWWWVWWWWWWWVWWWWWWWVWWWWWWWVWWWWWWWVWWWWWWWVWWWWWWWVWWWWWWWVWWWWWWWVWWWWWWWVWWWWWVWWW",
        "W        I                                                                                              W",
        "W                                                                                                       W",
        "W                                                                                                       W",
        "W                                                                                                       W",
        "WWWWWVWWWWWWWVWWWWWWWVWWWWWWWVWWWWWWWVWWWWWWWVWWWWWWWVWWWWWWWVWWWWWWWVWWWWWWWVWWWWWWWVWWWWWWWVWWWWWVWWW W",
        "WIIII                                                                 I                                 W",
        "WI  I                                                                                                   W",
        "WI  I                                                                                                   W",
        "WIIII                                                                                                   W",
        "W WWWWWVWWWWWWWVWWWWWWWVWWWWWWWVWWWWWWWVWWWWWWWVWWWWWWWVWWWWWWWVWWWWWWWVWWWWWWWVWWWWWWWVWWWWWWWVWWWWWVWWW",
        "W                                                                                                       W",
        "W                                                                                                       W",
        "W                                                                                                       W",
        "W                                                                                                       W",
        "WWWWWVWWWWIIIVWWWWWWWVWWWIWWWVWWWWWWWVWWWWWWWVWWWWWIWVWWWWWWWVWWWWWWWVWWWWWIWVWWIIIIWVWWWWWWWVWWWWWVWWW W",
        "W                                                                                                       W",
        "W                                                                                                       W",
        "W                                                                                                       W",
        "W                                                                                                       W",
        "W WWWWWVWWWWWWWVWWWWWWWVWWWWWWWVWWWWWWWVWWWWWWWVWWWWWWWVWWWWWWWVWWWWWWWVWWWWWWWVWWWWWWWVWWWWWWWVWWWWWVWWW",
        "W                                                                                                       W",
        "W       I                                                                                               W",
        "W                                                                                                       W",
        "W                                                                                                      IW",
        "WWWWWVWWWWWWWVWWWWWWWVWWWWWWWVWWWWWWWVWWWWWWWVWWWWWWWVWWWWWWWVWWWWWWWVWWWWWWWVWWWWWWWVWWWWWWWVWWWWWVWWW W",
        "W                                                                                                       W",
        "W                                                                                                       W",
        "W                                                                                                       W",
        "W                                                            I                                          W",
        "W WWWWWVWWWWWWWVWWWWWWWVWWWWWWWVWWWWWWWVWWWWWWWVWWWWWWWVWWWWWWWVWWWWWWWVWWWWWWWVWWWWWWWVWWWWWWWVWWWWWVWWW",
        "W                                                                                                       W",
        "W                                                                                                       W",
        "W                                                                                                       W",
        "WII                                                                                                     W",
        "WWWWWVWWWWWWWVWWWWWWWVWWWWWWWVWWWWWWWVWWWWWWWVWWWWWWWVWWWWWWWVWWWWWWWVWWWWWWWVWWWWWWWVWWWWWWWVWWWWWVWWW W",
        "W                                                                                                       W",
        "W                                                                                                       W",
        "W                                                                                                       W",
        "W                                                                                        I              W",
        "W WWWWWVWWWWWWWVWWWWWWWVWWWWWWWVWWWWWWWVWWWWWWWVWWWWWWWVWWWWWWWVWWWWWWWVWWWWWWWVWWWWWWWVWWWWWWWVWWWWWVWWW",
        "W                                                                                                       W",
        "W                                                                                                       W",
        "W                                                                                                       W",
        "W                               I                                                                       W",
        "WWWWWVWWWWWWWVWWWWWWWVWWWWWWWVWWWWWWWVWWWWWWWVWWWWWWWVWWWWWWWVWWWWWWWVWWWWWWWVWWWWWWWVWWWWWWWVWWWWWVWWW W",
        "W*                                                                                                      W",
        "W                                                                                                       W",
        "W                                                                                                       W",
        "W                                                                                                       W",
        "W WWWWWVWWWWWWWVWWWWWWWVWWWWWWWVWWWWWWWVWWWWWWWVWWWWWWWVWWWWWWWVWWWWWWWVWWWWWWWVWWWWWWWVWWWWWWWVWWWWWVWWW",
        "DDDDDDDDDDDDDDDDDDDDDDDDDDDDDDDDDDDDDDDDDDDDDDDDDDDDDDDDDDDDDDDDDDDDDDDDDDDDDDDDDDDDDDDDDDDDDDDDDDDDDDDDD",
)
