(
        "DDDDDDDDDDDDDDDDDDDDDDDDDDDDDDDDDDDDDDDDDDDDDDDDDDDDDDDDDEDDDDDDDDDD",
        "D                    P          TTTTTTTTTTTTT        P             D",
        "D      N                P   p                       P              D",
        "D      S        N  N  N  N  N  N  NN  NNN  NN      P               D",
        "D               P  P  P  P  P  P  PP  PPT  PP      P               D",
        "DN                                                                 D",
        "DS                                                                 D",
        "D    N      N                                  PPPP                D",
        "D    P      P                                                      D",
        "D                          N  N                        T           D",
        "D                 N   NN   P  P                                    D",
        "D                 P   PP                                           D",
        "D                                                                  D",
        "D                     N    N                                       D",
        "D                     P    P                                       D",
        "D                                                                  D",
        "D   N        NN                                                    D",
        "D   P        PP                                                    D",
        "D                                                                  D",
        "D                                                                  D",
        "D                                        N                         D",
        "D                                        P       N                 D",
        "D                                                P  N              D",
        "D                                                   T              D",
        "DDDDDDDDDDDDDDDDDDDDDDDDDDDDDDDDDDDDDDDDDDDDDDDDDDDDDDDDDDDDDDDDDDDD",
        )
