(
        "PPPPPPPPPPPPPPPPPPPPPPPPPPPPPPPPPPPPPPPPPPPPPPPPPPPPPPPPPPPPPPPPPPPP",
        "PTTTTTTTTTTTTTTTTTTTTTTTTTTTTTTTTTTTTTTTTTTTTTTTTTTTTTTTTTTTTTTTTTTP",
        "PT     N                 N                 N                N     TP",
        "PT                               N N                              TP",
        "PT                                                                TP",
        "PT *        N                                          N          TP",
        "PT                  N                          N                  TP",
        "PT                                                                TP",
        "PT                                                                TP",
        "PT                                                                TP",
        "PT                                                                TP",
        "PTN                                                              NTP",
        "PT                              N   N                             TP",
        "PT              N                                   N             TP",
        "PT                                                                TP",
        "PT                                                                TP",
        "PT N                                                            N TP",
        "PT                                                                TP",
        "PT                                                                TP",
        "PT                               N N                              TP",
        "PT                                                                TP",
        "PT                                                                TP",
        "PTN                                                              NTP",
        "PTTTTTTTTTTTTTTTTTTTTTTTTTTTTTTTTTNTTTTTTTTTTTTTTTTTTTTTTTTTTTTTTTTP",
        "PPPPPPPPPPPPPPPPPPPPPPPPPPPPPPPPPPEPPPPPPPPPPPPPPPPPPPPPPPPPPPPPPPPP",
        )
